1111111111
1001000C01
10P0001111
1011000E01
10C1010001
1100010C01
1111111111