111111111111111
1000C1001000101
100111000010001
1000000C0010C01
100111110000011
1000100010P1011
100010E00100011
11C010100101111
10000111000C001
111111111111111