111111111111111
100CCC0P0CCC001
10CCCCCECCCCC01
1CCCCCCCCCCCCC1
10CCCCCCCCCCC01
101CCCCCCCCC101
1011CCCCCCC1101
100001CCC100001
1000001C1000001
111111111111111