111111111111111
1C100010C1000E1
101000001000011
100C01111010001
111011000010001
10001C011110001
101010000011101
101C00101010001
10C111C01010101
100000001C001C1
11P001111111111
1C100010C1000E1
101000001000011
100C01111010001
111011000010001
10001C011110001
101010000011101
101C00101010001
10C111C01010101
100000001C001C1
110001111111111
111111111111111